000000T000
000TM00000
0000000000
00000TTCAA
T000000B00
00CG0HAF0v
AAF00P000v
0000PP000v
0200010600
0M000TT*P0
totalTurns=10
treasures=5,5